50
15

##################################################
#CCCCCCCCCCCCCCCCCCCCCCCCCCXXXXXXXXXXXXXXXXXXXXCC#
#CCCCCCCCCCCCCCCCCCCCCXXXXXXXXXXXXXXXXXXXXXXXXCCC#
#CCCCCCCCCCCCCCAAAAAAAAAAAAAAAAAAAAAAAAXXXXXXXXXC#
#CCCCCCCAAAAAAAAAAAAAAAAAAAAAAAAAAAAAAAAAAXXXXXXX#
#CCCCAAAAAAAAAAAAAAAAAAAAAAAAAAAAAAAAAAAAAAACCCCC#
#CCAAAAAAAAAAAAAAAAAAAAAAAAAAAAAAAAAAAAAAAAAAACCC#
#CAAAAAAAAAAAAAAAAAAAAAAAAAAAAAAAAAAAAAAAAAAAAAAA#
#CCCAAAAAAAAAAAAAAAAAAAAAAAAAAAAAAAAAAAAAAAAAAAAA#
#CCCCCAAAAAAAAAAAAAAAAAAAAAAAAAAAAAAAAAAAAAAAAAAX#
#CCCCCCCCCAAAAAAAAAAAAAAAAAAAAAAAAAAAAAAAAAAXXXXX#
#XXXXXXXXXXXXXXXAAAAAAAAAAAAAAAAAAAAAAAAAAXXXXXCC#
#XXXXXXXXXXXXXXXXXXXXXXAAAAAAAAAAAAAAAAAXXXXCCCCC#
#XXXXXXXXXXXXXXXXXXXXXXXXXXXXXXXXXXXXXXXXXXXXXXXX#
##################################################
