70
20
######################################################################
#CCCCCCCCCCCCCCCCCCCCCCCCCCCCCCCAAAAAAAAAAAAAAAAAAAAAAAAAXXXXXXXXXXXX#
#CCCCCCCCCCCCCCCCCCCCCCCCCCCCAAAAAAAAAAAAAAAAAAAAAAAAAAAXXXXXXXXXXXXX#
#CCCCCCCCCCCCCCCCCCCAAAAAAAAAAAAAAAAAAAAAAAAAAAAAAAAAAAXXXXXXXXXXXXCC#
#CCCCCCCCXXXXXXXXAAAAAAAAAAAAAAAAAAAAAAAAAAAAAAXXXXXXXXXXXXXXXXXXXCCC#
#XXXXXXXXXXXAAAAAAAAAAAAAAAAAAAAAAAAAAAAAAXLXXXXXXXXXXXXXXXXXXXXXXXXC#
#XXXXXXAAAAAAAAAAAAAAAAAAAAAAAAAAAAAAAAXXXXXXXXLLLLLLLLLLLLLXXCCCCCCC#
#XXXAAAAAAAAAAAAAAAAAAAAAAAAAAAAAAAAAAXXXXXXXXXXXXXXXXXLLLLLXXXXCCCCC#
#XXAAAAAAAAAAAAAAAAAAAAAAAAAAAAAAAAXXXXXXXXXXXXXXXXXXXXXCCCCCCCCCCCCC#
#XAAAAAAAAAAAAAAAAAAAXXXXXXXXXXXXXXXXXXXXXXXXXXXXXXXXXXXXCCCCCCCCCCCC#
#AAAAAAAAAAAAAAAAAAAAXXXXXXXXXXXXXXXXXXXXXXXXXXXXXXXXXXXXXXXXXXXXXXXC#
#AAAAAAAAAAAAAAAAAAAAAAXXXXXXXXXXXXXXXXXXXXCCCCCCCCCCCCCCCCCCCCCCCCCC#
#AAAAAAAAAAAAAAAAAAAAAAAXXXXXXXXXXXXXXXXXCCCCCCCCCCCCCCCCCCCCCCCCCCCC#
#XXXXAAAAAAAAAAAAAAAAAAAAAXXXXXXXXXXXXXXXXXAAAAAAAAAAAAAAAAAAAAAAAAAC#
#XXXXXXAAAAAAAAAAAAAAAAAAAAAAXXXXXXXAXXXAAAAAAAAAAAAAAAAAAAAAAAXLLLLX#
#XXXXXXXXXAAAAAAAAAAAAAAAAAAAAAXXXAAAAAAAAAAAAAAAAAAAAAAAAAAAAAXCCCCC#
#XXXXXXXXXXXXAAAAAAAAAAAAAAAAAAAAAAAAAAAAAAAAAAAAAAAAAAAAAAAACCCCCCCC#
#XXXXXXXXXXXXXXXXXXXAAAAAAAAAAAAACCCCCCCCCCCCCCCCCCCCCCCCCCCCCCXXXXXX#
#XXXXXXXXXXXXXXXXXXXXXXXXXXCCCCCCCCCCCCCCCCCCCCCCXXXXXXXXXXXXXXXXXXXX#
######################################################################